0
27,0,0,0,1,0
43,3,0,0,0,0
46,0,1,0,1,0
60,0,0,1,0,1
64,1,0,0,0,0
75,0,0,1,1,0
79,0,1,0,0,1
91,0,1,0,0,0
94,3,0,0,0,0
97,0,0,0,0,1
100,0,1,0,0,0
112,1,0,3,0,0
116,0,0,0,1,0
129,0,3,0,0,0
133,0,0,0,1,0
136,0,0,1,0,1
140,0,1,0,0,0
143,0,1,0,3,0
147,0,0,3,0,1
179,1,0,0,0,0
182,0,0,0,3,0
187,0,0,1,1,1
191,1,3,0,0,1
195,1,0,1,1,0
198,0,0,0,1,3
